wwwwwwwwwwwwwww
ws          www
w www ww ww   w
w w  w   w  w w
w w ww w w ww w
w w  w w w ww w
w  w ww w w   w
www       w www
w   ww ww     w
w w     wwwww w
w w wwww      w
www ww   wwwwww
w     wwwwww  g
w   w        ww
wwwwwwwwwwwwwww