wwwwwwwwwwwwwww
ws          www
w www ww ww   w
w w  w   w  w w
w w ww w w ww w
w w  w w w ww w
w  w ww w w   w
www       w www
w   ww ww     w
www     wwwww w
www wwww      w
www wwww wwwwww
w   wwwwwwww gw
w            ww
wwwwwwwwwwwwwww